NO ./Assets/Textures/NO.png
DO ./Assets/Textures/NO2.png
SO ./Assets/Textures/SO.png
WE ./Assets/Textures/WE.png
EA ./Assets/Textures/EA.png
F 220,100,25
C 25,30,205

1111111111111111111 1111111111111111
1000000001000002000120000000000001
100000001 10N10100002000000000111111
111111100100111 111111111111111111111111
      10020011
11111111111111