NO ./Assets/Textures/NO.png
DO ./Assets/Textures/NO2.png
SO ./Assets/Textures/SO.png
WE ./Assets/Textures/WE.png
EA ./Assets/Textures/EA.png
F 220,100,25
C 25,30,205

111111111
101000001
102001001
100000001
101000001
100000011111
100000000011
1N0000010001
111111111111