NO ./Assets/Textures/NO2.png
SO ./Assets/Textures/SO2.png
WE ./Assets/Textures/WE2.png
EA ./Assets/Textures/EA2.png

F 4294967299,100,25
C 25,30,205

111111 11111111111111
100000100000000000001
100000100000000000001
100000000000000000001
1000000N0000000000001
111111111111111111111