NO ./Assets/Textures/NO.png
DO ./Assets/Textures/NO2.png
SO ./Assets/Textures/SO.png
WE ./Assets/Textures/WE.png
EA ./Assets/Textures/EA.png
F 220,100,25
C 25,30,205

111111111111111111111111111111111111111111111111111111111111
100000000000000000000000000000000000000000000000000000000001   
100000000000000000000000000000000000000000000000000000000001
100000000000000000000000000000000000000000000000N00000000001
100000000000000000000000000000000000000000000000000011111111
100000000000000000000000000000000000000000000000000022000001
100000000000000000000000000000000000000000000000000010000001
100000000000000000000000000000000000000000000000000010000001
100000000000000000000000000000000000000000000000000010000001
100000000000000000000000000000000000000000000000000011111111
100000000000000000011111111111111100000100000000000000000001
1000000000000000001               10000000000000000000000001
1000000000000000001               10000000000000000000000001
1000000000000000001               10000000000000000000000001
1000000000000000001               10000000000000000000000001
1000000000000000001               10000000000000000000000001
1000000000000000001               10000000000000000000000001
1000000000000000001               10000000000000000000000001
100000000000000000011111111111111100000000000000000000000001
100000000000000000000000000000000000000000000000000000000001
100000000000000000000000000000000000000000000000000000000001
100000000000000000000000000000000000000000000000000000000001
100000000000000000000000000000000000000000000000000000000001
100000000000000000000000000000000000000000000000000000000001
100000000000000000000000000000000000000000000000000000000001
100000000000000000000000000000000000000000000000000000000001
100000000000000000000000000000000000000000000000000000000001
100000000000000000000000000000000000000000000000000000000001
100000000000000000000000000000000000000000000000000000000001
100000000000000000000000000000000000000000000000000000000001
100000000000000000000000000000000000000000000000000000000001
100000000000000000000000000000000000000000000000000000000001
100000000000000000000000000000000000000000000000000000000001
100000000000000000000000000000000000000000000000000000000001
100000000000000000000000000000000000000000000000000000000001
100000000000000000000000000000000000000000000000000000000001
100000000000000000000000000000000000000000000000000000000001
100000000000000000000000000000000000000000000000000000000001
100000000000000000000000000000000000000000000000000000000001
100000000000000000000000000000000000000000000000000000000001
100000000000000000000000000000000000000000000000000000000001
100000000000000000000000000000000000000000000000000000000001
10000000000000000000000000000000000000000000000000000000001
100000000000000000000000000000000000000000000000000000000001
111111111111111111111111111111111111111111111111111111111111
