NO ./Assets/Textures/NO.png
DO ./Assets/Textures/NO2.png
SO ./Assets/Textures/SO.png
WE ./Assets/Textures/WE.png
EA ./Assets/Textures/EA.png
F 220,100,25
C 25,30,205

111111 11111111111111
100000100000000000001
100000100000002000001
100000000000000000001
1000000N0000000000001
111111111111111111111