NO ./Assets/Textures/NO.png
DO ./Assets/Textures/NO2.png
SO ./Assets/Textures/SO.png
WE ./Assets/Textures/WE.png
EA ./Assets/Textures/EA.png
F 220,100,25
C 25,30,205

111111111
100000001
100000001
100000001
101000001
100000001111
100000000001
1N0000010001
111111111111