NO ./Assets/Textures/NO2.png
SO ./Assets/Textures/SO2.png
WE ./Assets/Textures/WE2.png
EA ./Assets/Textures/EA2.png
F 2a,100,25
C 25,30,205
1111111
10000N1
111111
 
 111111
10000001
 111111