


NO ./Assets/Textures//north.png


                       SO ./Assets/Textures/south.png

WE ./Assets/Textures/west.png
      EA ./Assets/Textures/east.png

  F                         000000255,0,0
  C                                                     255,0,125
     
     11
    100111
     1111
      111
      111
1111111111111111111111111
10000000S0000000000000001
1000010000111111111111111
100000100001
100001000001
10001 100001 
100001000001
100000000001
100000000001
100000000001
100000000001
100000000001
100000000001111111
10000000000100011
100000000001111111
111111111111