


NO ./Assets/Textures/north.png


            SO ./Assets/Textures/south.png

WE ./Assets/Textures/west.png
      EA ./Assets/Textures/east.png

  F                         255,100,0
  C                                                     255,0,0


11111111111
10S01
10001
10001
10001
10001
 10001111111
  100000000011
   100000000001
   100000000001
   100000000001
   100000000001
   10000000111
  100000111
 1000011
111111
     
11
