NO ./Assets/Textures/north.png
SO ./Assets/Textures/south.png
WE ./Assets/Textures/west.png
EA ./Assets/Textures/east.png

F 255,100,0
C 255,0,0

11111111111111111111
100000000000000E0001
10000000000111111111
100000000001
100111111001
1001    1001
1001    1001
100111111001
100000000001
100000000001
100000000001
100000000001
100000000001
100000000001
100000000001
111111111111
1111






