NO ./Assets/Textures/NO.png
SO ./Assets/Textures/SO.png
WE ./Assets/Textures/WE.png
EA ./Assets/Textures/EA.png
F 220,100,25
C 25,30,205

1111111111
1000000001
1N00000001
1000000001
1000000001
1000000001
1000000001
1111111111