NO ./Assets/Textures/NO.png
SO ./Assets/Textures/SO.png
WE ./Assets/Textures/WE.png
EA ./Assets/Textures/EA.png
F 220,100,25
C 25,30,205


1111111111
1010000001111
101N000001101
1000100101101
1000000101101
1100010101101
1000000001101
1000000001101
1000000001101
1000000001101
1000010001101
10001 1001101
1000010001101
1001000001101
1000000001101
1000000001101
1000000001101
1000110001101
1000110001101
1000000001101
1000000001101
1000000001101
1000000001101
1000000001101
1000001001101
1000000001101
1000000001101
1000000001101
1000000001101
1000000001101
1000000001101
1000000001101
1000000001101
1000000001101
1000000001101
1000000001101
1100000001101
1000000001001
1000000001101
1000000001101
1000000010001
1000000000001
1000000000001
1000000000001
1000000000001
1000000000011
1111111111111
