NO ./Assets/Textures/NO2.png
SO ./Assets/Textures/SO2.png
WE ./Assets/Textures/WE2.png
EA ./Assets/Textures/EA2.png
F 220,100,0
C 225,30,0


1111111111
1010000001
1N10000101
1000100101
1000000101
1100010101
1000000101
1111111111
