NO ./Assets/Textures/NO.png
SO ./Assets/Textures/SO.png
WE ./Assets/Textures/WE.png
EA ./Assets/Textures/EA.png
F 220,100,0
C 225,30,0

11111111
10100001
10100001
10001001
10000001
110N0101
10000001
11111111
