NO ./Assets/Textures/NO.png
SO ./Assets/Textures/SO.png
WE ./Assets/Textures/WE.png
EA ./Assets/Textures/EA.png
F 220,100,25
C 25,30,205

1111  11111
1010110001111
10100000011N1
1000100101101
1000000101101
1100010101101
1000000001101
0000000001101
1000000000001
1000100001101
1111 11101101
1       11001
1111111101101
1001000001101
1000000001101
1000000001101
1000000001101
1000110001101
1000110001101
1000000001101
1000000001101
1000000001101
1000000001101
1000000001101
1000001001101
1000000001101
1000000001101
1000000001101
1000000001101
1000000001101
1000000001101
1000000001101
1000000001101
1000000001101
1000000001101
1000000001101
1100000001101
1000000001001
1000000001101
1000000001101
1000000010001
1000000000001
1000000000001
1000000000001
1000000000001
1000000000011
1111111111111
