NO ./Assets/Textures/north.png
SO ./Assets/Textures/south.png
WE ./Assets/Textures/west.png
EA ./Assets/Textures/east.png
F 255,100,0
D 255,0,0




11111111111111111111
10000000000000000001
10000000000111111111
100000000001
100000000001
100000000001
100000000001
100000000001
100000000001
100000000001
100000000001
100000000001
100000000001
100000000001
100000000001
111111111111
